################
#X#    @       #
# # V     V    #
# #     V    # #
# # V      V # #
# #          # #
# #   s      # #
# #          # #
# #          # #
# #          # #
# #          # #
# #          # #
# #          # #
# ############ #
#              #
################
